25 25
b 8 c 5 b c b a 8 e d 9 e b a 8 e b 8 a a 8 e 9 e 
9 4 1 6 d 1 a c 1 a 6 3 8 a c 1 8 e 1 8 e 1 a 4 d 
7 7 1 8 2 0 c 3 0 c d b 2 c 3 4 5 b 4 1 e 7 b 2 4 
b 8 4 3 c 7 7 d 5 7 5 d d 1 c 7 1 e 5 3 8 c b 8 6 
d 7 1 c 5 9 e 3 0 a 2 4 1 4 3 e 1 e 7 9 6 1 e 1 e 
3 8 4 5 3 0 e 9 2 8 c 3 6 1 e b 6 d b 4 b 6 b 2 c 
b 6 7 5 d 3 c 7 d 5 7 d b 0 e d 9 6 9 2 a c b c 5 
d d 9 0 0 e 5 b 2 2 8 4 9 0 a 2 2 c 5 b c 5 d 5 7 
3 2 6 5 7 b 0 8 e d 7 7 5 7 b 8 c 5 3 a 4 3 6 1 c 
b a 8 2 c 9 6 5 d 3 a a 6 d 9 4 3 2 8 a 0 8 a 6 7 
9 e 5 9 6 1 e 1 2 8 e b c 3 6 5 b 8 2 e 5 5 b a c 
3 a 4 5 b 6 b 0 c 3 c d 1 8 a 4 d 1 e b 4 3 a 8 6 
9 e 7 7 d d d 5 1 e 7 1 4 3 c 5 1 6 b a 4 9 e 3 e 
1 8 a a 6 5 3 4 1 a c 7 7 b 4 7 5 d d 9 0 4 d b c 
7 5 9 a 8 0 c 5 7 9 0 8 a e 7 d 7 5 5 5 7 3 0 8 6 
9 4 5 b 4 7 3 6 9 4 7 3 a e d 1 8 2 2 4 b c 7 1 e 
7 5 1 c 3 c 9 e 7 7 b 8 a a 4 5 7 d 9 4 b 0 e 3 c 
9 4 7 3 c 1 6 d b a 8 2 8 c 1 2 a 4 7 5 b 0 a a 6 
5 3 a 8 6 1 e 3 a c 5 d 7 7 1 e d 3 c 1 c 5 b c d 
1 8 e 3 e 3 e b 8 6 1 6 9 e 1 8 6 9 4 7 5 1 8 6 5 
7 3 8 8 c d d 9 2 a 4 9 2 c 5 3 e 7 5 d 5 5 7 d 5 
9 a 6 5 1 6 5 1 8 e 5 5 9 6 3 e 9 e 7 5 7 3 8 2 4 
7 d b 4 3 c 3 6 5 b 2 6 5 9 8 a 2 8 e 5 b 8 6 b 4 
d 5 9 2 e 1 c d 1 e 9 8 2 6 5 d b 0 a 2 c 3 a c 7 
3 2 6 b a 6 3 6 7 b 6 7 9 a 2 2 e 3 a e 3 e b 2 e 
