100 100
b a a c 9 8 e b a 8 a c b 8 a e d d 9 a c b 8 e d 9 e 9 8 a a 8 8 a 8 e 9 8 a a 8 8 e b 8 a 8 8 a e d 9 c d 9 c d d d b c 9 e b 8 c 9 e d d b a a c b 8 a c 9 e 9 8 a e 9 2 a 8 8 e d b a 8 a a a 8 8 e 
d b 8 6 7 5 b 8 a 2 c 5 b 2 8 a 0 2 2 e 7 b 2 c 5 5 9 6 3 8 e 7 5 b 6 9 6 5 9 c 7 3 a a 2 c 7 5 b c 3 4 7 1 4 3 0 2 0 a 4 5 b c 7 5 3 c 5 1 a c 9 6 d 5 b 4 3 a 4 5 9 8 0 e d 7 1 e 5 b 8 6 9 c d 7 7 d 
1 8 2 a a 2 8 2 c d 7 1 8 a 6 b 0 a a e b 8 8 6 3 0 4 9 8 2 8 e 3 a 8 2 e 1 6 1 a 8 a c b 2 e 3 a 4 9 2 c 5 7 b 0 e 7 d 3 0 8 6 b 0 a 6 3 4 d 3 0 e 3 6 b 4 b 8 6 5 5 7 7 9 0 e 3 8 4 d 1 c 7 5 3 c b 4 
5 7 d d d 9 2 c 5 5 b 4 3 8 c d 3 a c d b 4 3 a 8 6 7 5 1 e 5 b 8 c 5 b a 0 e 1 e 7 9 4 d d d 9 e 1 6 9 6 1 c d 3 e b 2 a 4 3 c b 0 c b a 4 3 8 2 a e d 9 4 9 6 9 6 1 e b 4 1 8 a 6 3 6 5 7 9 6 b 4 9 6 
1 e 1 2 6 5 b 6 5 3 8 4 d 7 7 1 a a 2 6 d 7 b 8 2 e b 6 5 d 7 d 5 5 1 e 9 2 c 3 c b 6 3 4 1 0 2 e 5 9 2 e 5 7 3 8 c 9 8 8 4 b 2 8 4 3 c 9 0 e 3 8 a a 2 4 5 5 9 2 a 2 8 c 7 7 5 9 c d 9 4 9 2 c d 5 1 e 
3 c 3 a a 0 a e 1 e 7 3 4 b c 1 e b 8 8 2 a 8 2 a e 9 a 6 3 8 2 6 1 2 e 7 9 2 c 1 a c 9 0 6 3 e b 4 3 8 a 4 d b 4 3 4 7 5 5 b a 6 7 9 2 6 7 d b 2 c b 8 4 1 6 1 a 8 e 5 7 d 9 6 7 1 2 6 3 6 9 2 2 0 2 e 
d 7 d b 8 2 c b 6 9 a 8 4 9 2 0 a a 6 3 8 e 1 e b c 1 c d b 0 c d 1 8 c b 2 e 5 5 b 6 5 5 d 9 c 9 6 b 2 c 7 1 c 7 b 2 c 7 5 d d 9 8 2 a 8 a 2 8 e 7 d 7 7 7 9 6 b 4 d 5 d 5 1 a 8 4 9 e b a 2 e d 5 9 c 
5 d 1 c 5 9 0 a c 5 b 6 7 1 e 3 c d b c 5 b 4 9 a 4 7 5 5 b 4 7 5 5 7 5 b c d 5 3 e b 4 5 5 7 3 2 a 8 e 5 9 6 1 a a c 3 c 3 2 4 5 3 a c 3 c b 0 a c 3 8 e b 0 e b 4 3 2 4 5 7 b 4 1 2 c d b 8 c 3 0 6 7 
3 0 6 3 4 7 5 d 7 7 9 8 c 5 d b 6 1 a 4 5 d 3 2 c 7 b 6 5 9 2 c 3 0 e 5 b 2 4 1 a a c 7 3 0 8 c 9 a 6 9 2 0 e 3 c b 6 b 0 e b 6 3 8 e 1 c 7 9 4 9 2 a 2 a c 3 8 c 7 d 9 6 5 b 8 6 1 c 1 6 d 5 3 c 1 c d 
d 5 d d 5 d 3 6 9 e 7 7 3 2 0 c 9 2 c 3 2 4 9 e 3 e d d 1 2 e 7 b 0 e 1 a c 1 2 c b 4 b c 5 7 7 1 a e 7 b 0 c 9 2 e d 9 2 c b a 8 6 d 5 7 9 6 5 7 9 e 9 8 4 9 6 5 b 0 6 9 4 d 7 b 4 7 3 a 6 3 c 3 6 1 6 
3 4 5 3 2 2 a 8 2 8 8 e b a 6 5 5 b 6 d 9 0 0 8 e d 1 0 6 d 9 a a 4 d 3 e 5 7 d 7 9 4 9 2 0 a e 5 9 c 9 a 6 7 5 d b 2 6 d 5 b 8 2 c 5 1 e 1 e 5 d 1 a 6 7 7 1 e 1 e 3 e 7 3 0 c 9 2 a 8 8 8 e 3 c b 0 e 
a 0 2 8 a c b 4 d 5 3 e b 8 e 5 1 e 9 0 6 7 7 7 d 3 4 5 9 0 6 b c 3 4 9 e 5 b 4 d 5 5 7 d 1 8 e 7 7 1 0 c 9 e 3 0 a a a 4 5 b 6 9 2 4 7 d 7 b 4 1 0 8 e d b 6 d 1 e d 9 e b 4 3 4 b a 6 5 3 a c 3 e 1 e 
d 5 b 0 c 3 e 7 1 2 a 8 e 1 e 5 5 b 4 1 8 8 8 8 0 e 7 5 5 3 8 a 2 c 5 5 b 6 9 6 3 6 7 b 4 5 5 b c b 4 5 3 2 c b 0 8 e b 4 3 a e 3 c 7 d 5 9 c 7 5 7 3 e 3 c b 0 6 b 4 5 9 8 6 9 2 a e b 4 d d 3 c b 0 e 
1 6 d 5 5 b 8 8 6 b c 1 8 4 9 4 7 d 5 7 7 5 7 7 7 9 e 7 7 b 0 e b 4 3 6 b 8 0 a c b 8 a 0 4 7 9 2 a 4 3 e 9 2 c 7 3 c d 1 c d b 8 2 c 1 4 7 3 a 4 b a 8 a 2 e 1 e b 4 1 4 1 c 5 b 8 a 8 4 5 1 c 1 c 7 d 
5 d 1 6 3 c 5 3 c b 4 5 5 7 7 5 d 3 2 8 c 3 a 8 a 0 a a a c 3 8 c 7 b 8 e 7 1 e 5 9 6 9 6 5 b 0 a e 5 9 e 3 c 3 e d 7 1 6 7 3 8 6 9 0 6 5 9 e 9 0 e d 1 8 e b 2 8 c 1 4 7 7 5 3 c 5 b 4 5 5 5 3 4 1 a 4 
5 1 0 e d 5 1 c 3 8 4 7 7 d d 3 2 8 c 7 5 b 8 6 d 1 8 c b 0 e 5 3 c b 4 d d 3 c 1 4 b 4 d 1 c 1 8 e 3 2 8 e 3 c 9 6 d 1 8 e d 5 b 6 1 e 1 6 9 6 3 c 1 6 3 c b a 4 5 5 3 e b 4 b 6 1 e 7 5 3 4 d 7 5 b 4 
5 7 5 d 5 5 5 7 b 4 3 c d 1 4 d b 6 1 e 5 b 0 e 5 5 5 1 e 7 b 6 9 2 a 0 0 6 9 4 7 5 d 5 3 4 7 5 3 c 9 e 1 e b 0 0 e 1 4 5 b 4 1 e b 6 d 5 b 0 c d 3 0 e d 7 9 e 5 7 3 c b c 3 a e 5 d b 4 b 4 1 e 3 c 7 
5 b 0 4 3 6 1 e b 6 9 0 6 5 7 1 e b 6 d 7 d 1 e 1 4 7 3 8 a a c 3 8 e 7 5 9 6 7 b 0 6 3 c 1 e 7 d 3 2 c 1 e b 4 7 d 7 7 3 a 4 1 a a c 1 6 d 7 1 2 e 1 a 4 9 0 8 2 a c 5 9 2 8 e 9 0 0 c 1 e 1 2 e d 1 e 
5 9 6 7 d 9 2 e b c 7 3 c 1 a 2 8 c 9 2 c 3 2 e 5 3 c d 1 c d 1 e 1 c 9 6 7 d d b 6 b c 7 3 8 a 0 8 c 7 5 d 9 2 c 5 b c d 9 6 1 e b 6 1 e 1 a 2 a c 1 c 7 7 5 3 8 e 5 3 2 c 7 d 5 5 7 5 1 c 7 d b 0 2 c 
5 3 c b 2 0 e b 8 6 b c 1 0 8 c 5 1 6 d 7 9 a a 0 e 7 3 4 5 1 6 b 4 5 3 8 e 3 0 8 8 a 2 a 8 4 9 6 7 5 d 5 5 7 9 4 5 9 2 2 0 c 3 8 c b 4 b 2 c d b 4 5 7 9 a 4 b 6 b 6 d b 0 e 1 6 7 b 4 5 7 d 3 a 4 d 5 
7 d 7 9 e 5 9 a 2 a 8 4 7 7 5 5 5 3 8 0 e 7 b c 7 d d 9 6 5 7 d 9 6 5 d 5 b a 4 7 3 c b a 4 7 3 a e 3 4 3 2 c 7 1 6 1 c d 7 7 b 6 1 c 1 e b 4 3 c 5 7 d 5 b 0 a a 8 e 3 8 0 e 3 c d 9 6 7 b 4 b 8 6 5 5 
d 3 c 3 8 2 6 9 a 8 6 3 e b 4 5 3 c 7 3 8 a a 2 a 4 1 4 d 7 9 0 2 e 7 3 2 8 e 7 d 9 2 8 e 1 e d 9 e b 0 e b 4 d 5 b 4 7 5 d 9 e 9 6 7 1 8 e 1 c 3 2 8 4 7 b 4 9 a 2 e d 5 7 b a 4 1 2 a e 9 2 e 7 b 4 7 
5 b 0 8 0 a e 3 c 3 a 8 e 9 4 3 e 5 d b 0 a a a c 5 7 3 0 e 5 5 9 8 e d d 3 a e 5 1 e 1 e 3 a 4 5 d 9 0 c b 0 6 7 9 0 e 1 2 6 9 2 e 9 6 3 e 7 3 c 9 4 7 9 e 7 5 9 c d 1 2 e b a 6 3 a e d 1 c b a c 1 c 
1 a 4 7 1 a e d 3 8 e 3 c 5 1 a c 7 1 a 2 c d 9 6 3 c b 0 c 5 3 6 3 8 2 2 a e 9 0 6 9 4 9 c b 6 5 1 4 7 3 c 5 d d 7 5 9 2 e d 7 b a 2 a c 9 c 9 6 5 5 9 2 e d 1 6 1 6 5 9 a 8 a 8 a c b 0 6 1 a 8 2 4 5 
7 9 0 c 3 c b 0 a 0 8 e 5 7 7 b 4 d 7 d 9 4 1 0 e 9 4 9 4 7 3 a 8 e 1 e b c d 7 5 d 5 1 6 3 8 e 3 6 3 a e 5 3 0 4 b 0 2 a c 1 e b 8 8 a 4 7 1 6 d 7 5 1 8 e 1 0 e 1 c 1 2 e 3 e 1 c 5 b 6 d 7 9 4 b 4 5 
b 4 7 7 9 4 9 0 c 7 5 d 1 a c d 1 0 e 1 4 5 7 5 d 5 7 7 5 b c b 4 b 2 c b 0 2 8 2 4 7 5 d d 3 c d 9 a a a 0 e 5 3 e 3 a c 3 4 b 8 4 3 e 1 c 7 b 2 8 2 6 5 b 6 5 b 4 7 3 e 9 e 9 6 5 3 8 8 2 c 7 3 e 5 5 
b 2 c d 5 7 5 5 7 9 6 3 2 e 5 5 5 3 c 7 5 7 d 7 5 5 b a 6 d 3 8 6 b 8 4 d 1 e 5 d 1 c 1 0 6 b 6 1 4 9 e d 5 b 0 e b 8 8 6 d 1 c 5 1 e d 5 3 8 c 9 6 b 8 0 a c 7 b 2 a 8 e 1 8 6 b 4 b 6 3 c 1 8 e b 4 7 
d b 4 3 0 e 5 3 e 5 9 a c b 2 4 7 9 6 d 3 8 4 b 2 0 8 8 8 4 9 6 9 e 7 7 5 1 e 5 3 4 7 7 3 c b a 4 1 2 e 5 1 e 3 c d 7 5 b 4 7 5 5 7 b 0 6 b 6 7 3 8 e 5 1 c 1 a a c b 0 e 5 7 9 c 3 a c 9 6 7 3 8 8 4 d 
5 b 2 c 7 b 4 b 8 2 4 d 1 e d 7 9 6 b 0 a 6 7 d b 4 5 5 5 7 7 d 1 a 8 8 6 3 c 7 d 5 d b 8 2 e d 7 1 e 9 4 7 d b 0 0 c 3 a 4 d 7 5 b 8 6 b 8 e b 8 0 e 7 5 7 3 e 9 2 c 1 e 3 a 4 5 9 a 6 1 c d b 4 5 3 4 
3 c 9 6 b a 4 b 4 b 6 3 4 b 0 8 2 c d 1 8 a e 1 8 6 5 5 7 b 8 6 5 b 4 3 a a 0 e 1 0 2 e 1 a e 1 c 1 a 4 3 a 6 b 4 7 3 a c 5 3 a 2 c 5 b a 2 8 a 6 3 c d 5 9 e d 5 9 4 1 c 9 a 4 7 1 a e 5 1 4 9 4 7 9 6 
b 0 2 a e b 0 c 3 8 e d 1 e 5 7 b 4 1 6 5 9 8 6 7 d 7 7 9 8 2 a 0 e 5 9 e b 6 d 7 3 c b 2 a c 7 1 6 d 1 8 c 9 e 3 8 a c 7 1 e d d 5 7 d 9 a 6 d d d 1 4 3 6 9 2 6 7 7 5 7 7 b 4 9 0 e b 4 7 5 5 7 d 1 c 
b 0 8 e b 8 6 5 d 5 9 4 3 c 3 8 c 7 1 e 5 7 1 a 8 2 c 9 6 5 b c 5 b 2 0 a a 8 4 d d 7 9 a 8 6 b 0 8 6 5 7 5 5 b 8 4 b 0 e 3 c 1 2 4 b 0 2 a e 5 3 2 4 3 e b 2 8 8 a e 1 a a e 5 5 3 a e 1 e 7 1 e 3 6 7 
b 6 1 c d 5 d 5 3 2 4 5 9 4 b 4 3 e 3 c 1 c 7 b 2 e 7 1 c 3 8 6 1 8 c 3 8 c 7 3 0 4 9 4 9 6 d d 5 7 9 0 e 7 1 8 6 7 9 6 9 c 5 3 c 1 e 3 a a c 1 a a 0 a a c b 4 1 e 9 0 8 a e 5 5 b c b 0 e d 3 a c d d 
b 8 6 1 6 5 5 1 e 9 6 5 7 3 e 7 d d b 4 7 3 8 a e b 8 6 5 b 4 9 4 5 7 b 4 7 b a 6 5 7 7 5 9 2 0 6 b 6 3 e b 4 5 d b 4 d 7 3 6 b 4 5 d 9 e d 5 7 b c 7 d d 5 b 4 3 e 5 7 7 9 8 4 3 8 2 c 7 9 0 c 9 0 0 6 
d 7 d 5 d 1 6 3 c 3 e 1 a a a a 6 1 a 4 9 c 3 c 9 e 7 9 6 d 7 5 7 7 b a 0 a a c b 2 8 e 5 7 b 2 8 e d d d d 7 3 0 c 3 0 e 9 a e 5 3 2 0 e 1 0 a c 1 8 6 3 0 e 3 c b 6 b 8 4 5 7 d 3 e 7 d 5 7 3 4 5 1 e 
3 8 0 0 6 1 e 9 2 e d 7 b 8 8 8 a 4 9 2 4 5 d 5 1 c 9 0 e 5 9 2 a 8 8 e 5 b c 7 d d 7 d 7 b c d 1 a 0 6 3 2 8 8 6 1 e 1 a 0 e d 3 a e 7 9 4 3 c 3 4 3 a e 1 a e 3 a a e 5 7 5 b 0 a 8 8 0 0 a c 5 5 1 c 
9 6 5 3 e 1 e 5 b 8 0 a c 7 5 7 9 6 5 b 6 1 6 1 6 5 5 3 a 4 3 8 c 7 3 c 3 a 6 9 2 0 8 0 a a 0 2 2 c 7 d b a 6 1 e 7 9 0 e 1 e 1 a 8 e d 7 7 9 6 d 1 a 8 e 3 a a e b a 8 2 c 7 9 6 d 7 7 5 5 d 5 7 5 5 7 
3 e 5 9 8 6 b 4 d 5 7 d 5 9 0 e 3 e 7 b c 5 d 5 d 5 5 d d 1 e 7 3 8 e 3 e 9 a 2 c 7 7 7 d b 4 b a 6 d 3 8 8 a 0 c d 7 1 e 3 a 2 c 1 e 5 9 e 7 d 3 4 9 0 8 a 8 a 8 c 9 6 b 6 b 2 a 4 d d 5 7 3 2 c 7 5 d 
d b 6 7 1 e d 5 1 2 c 3 4 5 7 d 9 8 e 9 6 7 1 6 3 6 5 3 2 4 9 e b 0 c b a 0 a c 7 d b a 0 a 2 c b a 0 8 6 7 9 4 5 1 8 0 a a 8 e 5 3 e 3 2 c d 3 8 4 5 7 7 d 1 e 5 7 3 a 8 a e b a 2 0 6 3 c d d 3 e 1 6 
1 e b a 4 d 1 6 7 9 6 b 2 0 a 4 5 1 a 2 c d 5 9 a e 3 a c 7 3 a c 7 1 a e 3 c 3 e 5 9 c 1 a e 5 9 e 5 3 c b 4 5 7 5 5 3 8 c 5 d 1 a e b 8 2 6 9 4 7 3 c 9 4 7 9 6 b a c 3 8 c b 8 e 1 a e 3 0 2 c d 1 e 
5 d d b 4 3 4 b a 6 d 9 8 6 9 6 5 7 b c 5 1 2 4 b 8 e 9 6 d 9 a 0 a 6 d b c 5 d d 5 5 3 0 c d 7 1 c 5 b 2 e 7 7 d 5 3 e 5 5 5 5 1 a 8 a 4 b 8 4 3 a c 1 6 7 d 7 b c d 1 8 4 3 8 6 9 0 a e b 4 d 5 5 7 d 
3 0 4 9 2 e 5 d 9 e 5 7 5 b 4 b 2 e d 1 0 6 9 4 b 4 d 5 9 6 5 9 2 8 8 2 a 6 5 5 3 2 4 9 6 5 5 9 6 1 6 9 8 8 c d 1 2 a c 7 7 1 4 1 e 1 e 1 e 7 1 c b 6 1 a a 0 e 9 2 4 7 7 5 d 7 9 6 3 8 a c 7 3 2 2 a 6 
9 6 3 0 c b 0 0 0 a 4 b 0 e 3 a c d 3 6 1 c 7 5 9 4 1 0 4 b 6 7 d 5 7 b c d 1 4 d b 6 7 d 7 1 6 b 0 8 6 7 7 7 5 1 8 c 3 c b 4 5 1 e 5 d 3 c b 4 7 b 8 2 e 9 0 a 6 d 1 8 e 3 0 c 7 9 a 4 d 5 d d 9 a c d 
1 c b 6 5 b 6 5 3 c 1 e 3 e b 8 2 4 9 c 7 1 e 3 4 7 7 7 1 8 e b 0 4 d b 2 0 4 3 2 a a c 3 8 0 a e 5 7 d d 9 a 0 4 7 3 c 7 9 6 7 3 c 1 2 e 1 e 1 a e 3 e d 7 3 8 c 3 4 7 9 c 5 7 9 6 9 4 3 0 6 5 5 b 2 4 
7 1 e d 5 9 e 5 d 7 3 e d d 9 2 e 5 7 5 d 5 d d 7 b a 8 6 3 a c 5 3 6 d d 7 7 d b a 8 2 e 7 1 8 c 3 c 5 1 4 9 6 3 8 e 5 d 3 e d b 6 1 c 9 2 c 7 d 9 c 9 0 8 8 4 5 d 5 b 6 5 5 b 6 b 4 5 9 6 9 0 6 d d 5 
d 5 9 4 5 5 9 0 0 8 a c 1 6 7 9 a 2 8 6 3 2 2 0 c d b 6 b 8 a 4 1 8 e 3 0 e 9 4 b 8 0 a 8 e 7 5 7 d 1 4 7 7 3 c 9 4 d 5 1 c d 1 8 8 6 7 7 9 4 d 1 6 7 5 7 7 5 7 7 5 3 8 c 3 2 a a e 7 5 1 e 7 3 8 6 3 6 
5 5 7 3 2 4 5 7 7 3 e 5 1 a e 3 8 e 1 c 9 c 9 4 5 3 8 e b 4 b 4 5 1 c b 0 a 6 5 b 6 1 e 1 a e 3 e 1 6 3 8 8 e 5 7 1 4 3 4 5 1 6 7 7 9 8 e 5 1 6 3 a a 4 b a 2 8 e 1 a 6 3 8 a a c b a 4 1 8 a 8 0 c 9 c 
3 2 e b 8 6 3 a 8 e b 0 0 e 9 8 0 e 5 5 7 3 4 5 5 9 0 8 a 6 d 5 7 7 7 d 3 a e 5 9 a 4 9 6 9 a 8 8 2 8 e 5 1 e 5 b 4 3 c 5 5 3 a e 9 4 1 a 6 3 8 a a e 5 b c d 7 d 3 e b a 4 b 8 6 d d 5 5 1 e 5 5 1 6 7 
9 8 e 9 4 d 9 c 5 b 8 6 1 c 5 5 7 b 6 3 8 e 5 7 7 7 5 5 b c 3 0 a a a 0 e d b 2 6 d 7 1 e 7 9 4 7 b 0 e 7 5 b 0 e 5 d 5 7 3 c b c 5 7 7 9 a 8 2 c 9 c 5 d 3 2 c 1 8 8 a 8 6 9 4 d 5 3 6 5 3 e 7 7 1 a c 
5 3 8 4 5 5 7 1 2 c 7 b 4 7 7 5 b c b a 0 e 3 e d b 6 3 c 3 a 4 b 8 a 0 a 2 8 8 a 2 e 5 b c 5 7 b a 0 8 e 1 e 7 9 6 3 0 c 9 2 c 3 4 9 a 2 e 7 9 0 6 5 1 2 c 9 0 6 7 3 e 5 9 6 3 6 5 9 a 0 8 c d b 4 b 4 
5 d 5 7 3 2 c 1 e 3 e b 4 d b 4 b 0 a 8 2 8 8 e 1 e d b 2 c b 4 b 4 d 5 d 9 6 5 b a a 0 e 3 4 d 9 c 5 5 d 5 d 9 6 9 a 4 7 5 b 2 c 7 1 8 a e b 6 5 d 7 3 c 7 5 3 a a e b 4 1 8 8 e 3 0 e 7 7 5 5 b 0 e 7 
1 6 7 9 c d 5 1 a e 9 e 1 6 d 7 b 4 9 6 d 7 5 b 0 a 4 b a 2 e 7 9 4 3 0 6 7 9 2 e d d 5 b a 0 6 7 3 6 1 4 7 5 3 c 7 d 7 b 2 c d 7 b 4 3 8 a a c 3 4 b c 1 c 3 a 8 c b c 5 7 7 7 b 8 6 b 8 a 0 6 b 0 c d 
3 a c 7 3 2 4 1 8 8 4 b 0 8 2 e 9 4 3 a 2 c 7 d 5 b 2 a 8 a a c 7 3 e 5 b 8 0 a 8 2 4 5 d b 2 c d d d 5 1 e 3 8 2 e 1 a 8 a 0 6 b 8 6 b 0 e b 4 d 1 c 1 4 7 d d 5 1 a 4 3 c 9 e 9 2 e b 0 e 5 b a 4 3 6 
9 c 1 8 a e 5 5 7 5 3 c 7 3 8 e 7 3 e b 8 2 e 1 6 b 8 a 6 d b 0 a a 8 0 c 7 5 b 4 d 5 1 6 b c 1 0 2 4 7 5 d b 6 d b 2 c 7 d 1 8 e 7 9 c 5 b a 2 6 7 5 5 1 e 5 1 6 1 c 3 c 3 6 d 7 d b a 2 c 3 c b 2 a c 
7 5 7 1 e b 6 1 e 3 c 1 e d 1 a 8 e b c 5 9 c 1 a c 1 a 8 4 d 1 8 e 7 5 7 d 5 b 6 5 5 3 e d 1 6 7 b 0 e 5 5 b a 0 c b 6 b 0 4 3 e 9 4 7 1 e b 8 a a 6 5 7 9 0 0 e 7 5 b 0 8 a 6 b 0 a 8 a 0 e 1 a a e 5 
9 2 e 7 d b 8 4 d d 7 7 d 3 2 e 1 e b 2 6 7 3 4 d 5 1 c 5 5 5 5 3 8 e 7 9 4 1 8 e 3 2 8 a 6 7 9 a a 0 c 7 3 8 a 6 3 a a a 4 3 a 8 6 7 9 6 d b 0 a a c 5 b 4 7 5 9 e 3 c 5 3 c b c 3 c 5 b 2 e 1 8 a c 5 
3 a 8 a 6 9 6 3 0 2 e d 5 d d d 1 a e d b c b 0 6 5 5 7 5 7 3 4 9 2 a a 4 7 7 1 e d d 3 a 8 e 5 9 8 4 1 e d 5 b c d b 8 e 3 8 e 3 8 c 3 8 2 c 5 d 9 4 7 9 4 b 6 5 d b 6 3 c 7 b 0 a 6 1 c d 9 4 7 b 6 5 
9 e 1 a a 0 8 e 3 a 8 2 6 3 0 6 1 a e 3 a 0 e 1 c 5 5 b 2 c b 4 3 8 a c 7 d 9 6 9 4 1 a c 5 b 4 7 7 7 3 8 6 1 a 6 3 a 0 a 8 2 e 9 6 5 d 5 b 6 5 3 4 3 e 7 1 e 9 2 4 d 9 a 4 d b 4 b 8 6 1 4 5 1 c b c 5 
3 c 1 e d 7 5 b 8 8 2 a e b 4 9 2 a a e b 0 e 7 5 7 3 e 9 4 b 0 e 5 9 0 e 3 0 e 7 1 6 9 0 4 9 6 b 8 a a 4 9 0 8 e d b 2 e 5 b a 0 e 5 1 6 d 9 2 c 3 8 e d 1 a 2 e 3 4 7 9 2 2 e 5 b 2 c 5 7 5 5 7 d 3 4 
b 2 0 a 2 e 3 e 7 5 b c d d 5 1 c d b 8 c 1 e 9 4 d 9 c 5 1 e 1 e 7 5 7 9 8 0 e b 2 c 7 7 7 1 a e 3 e 9 4 7 7 7 9 0 e 9 a 6 d b 0 e 5 5 b 2 4 b 0 c 1 a 4 1 e d d 9 4 b 0 e b 8 6 b 8 4 3 e 5 5 d 5 d 7 
9 e 1 a 8 8 a c b 2 a 2 0 6 1 4 3 6 b 4 7 5 9 6 1 4 5 5 7 7 d 1 c b 2 e 5 7 7 b a a 0 e 9 a 2 a 8 a c 7 3 e 9 c 7 5 9 4 d d 3 8 4 b 4 5 b c 5 d 5 7 3 e 7 3 8 0 4 5 1 c 5 d 9 4 b 8 4 1 e b 6 1 6 5 1 e 
1 e 1 c 7 3 e 1 e b c 9 6 9 6 3 8 e b 2 a 0 6 b 4 1 6 3 8 e 5 7 1 8 e 9 2 8 e b 8 a 6 d 1 8 a c 7 9 6 d d d 7 5 d 3 6 1 0 6 b 4 5 d 7 7 d 5 7 5 5 d d d b a 4 7 7 7 7 7 7 5 5 5 d 5 7 1 a 8 c 1 8 0 0 c 
3 8 6 7 9 a c 1 e b 4 1 e 5 9 e 3 c b a c 7 d d 5 1 e 9 4 9 0 e 5 3 c 7 9 2 c b 4 d b 0 6 3 e 1 e 3 c 1 6 1 a 4 5 9 a 6 3 8 e 7 3 0 a a 6 1 a 0 2 2 2 4 d b 4 9 c 9 8 a a 2 6 5 3 6 d 1 e 5 7 7 7 7 5 5 
d 3 8 a 0 c 7 1 a e 3 6 9 2 0 c b 2 8 a 2 8 0 4 5 7 b 4 1 6 7 9 2 e 5 9 0 e 1 e 1 4 d 7 b a a 0 c 9 0 2 e 1 c 3 2 0 8 e d 1 a e 9 0 c b 8 6 b 2 8 a e 3 0 e 1 4 7 7 1 e b a 8 0 c d 1 6 9 2 8 c b 8 6 7 
3 c 7 d 7 5 b 2 a c d 9 2 e 7 5 b 8 2 e 9 6 7 7 7 b a 6 7 b 8 2 8 c 7 7 5 b 4 9 6 5 1 e d 9 c 7 5 7 5 b a 6 5 d d 5 5 d 5 5 b 8 6 5 3 e 7 d b c 5 d b a 2 c 7 3 a e 1 a e 9 6 5 1 4 7 b 6 9 4 3 e 1 8 c 
b 4 b 0 a 2 8 c d 5 3 0 e b 8 6 9 4 d b 4 b 8 8 a c 9 e d b 4 d 5 5 d d 1 e 5 3 c 1 2 c 5 7 5 b 6 9 2 e b 8 0 2 6 7 1 4 1 2 e 3 e 1 8 8 8 2 a 6 1 4 9 e 9 2 c b 8 8 2 a c 1 e 7 7 1 e b 8 4 1 e b 4 7 7 
b 0 a 0 c b 4 5 3 2 c 5 b c 7 b 4 1 0 e 7 b 4 1 e 1 0 e 5 d 3 4 7 7 5 1 0 c 5 9 4 7 b 2 4 9 6 b 8 2 a c d 5 5 d 9 e 7 7 1 e 9 a a 4 7 7 1 a 8 c 7 5 1 c 3 e 5 d 7 1 e 9 6 1 e d b 2 e d 5 7 1 e 9 2 8 c 
9 2 e 5 5 b 6 3 e 9 6 3 c 1 e b 4 7 3 c d b 4 3 e 5 3 a 2 4 b 2 8 a 4 7 7 7 5 7 5 9 a c 3 6 9 a 4 d d 7 5 5 3 2 2 8 e b 6 b 0 a e 7 9 8 6 d 7 7 9 2 6 3 e d 5 3 a 6 9 2 c 3 c 1 8 c 9 2 4 b 6 b 0 e 7 7 
5 9 8 6 1 8 a c d 3 a e 3 0 a c 3 a e 3 6 b 0 e 9 0 a e b 2 8 a 2 e 1 c 9 e 1 e 3 6 9 6 d b 0 e 1 6 3 8 2 0 c 9 e 3 8 e d 9 0 a e 9 6 3 8 6 b 8 2 a e b 8 0 2 a a e 7 9 2 e 5 7 7 3 4 b 2 c b a 2 a 8 c 
7 5 7 b 4 1 e 3 4 9 e d b 0 e 1 a 8 e b 8 c 5 d 7 1 e b a a 0 c b 8 6 1 6 b 2 c 9 8 2 8 6 b 4 d 1 e d 1 e 5 5 3 a a 0 e 3 6 1 a e 7 d 9 4 b c 3 e d b a 4 1 a 8 8 e 9 2 a c 5 d b a 4 d b 0 e b a 8 4 7 
b 0 e 9 4 1 8 c 3 0 a 6 d 5 d 1 e 1 8 e 5 7 1 2 e 7 b c b 8 6 7 d 5 b 0 8 e b 4 5 3 e 5 d d 5 5 1 c 1 0 e 7 3 c d 9 2 a c d 3 8 c d 5 5 1 a 0 e 9 2 a e 5 7 b 4 3 c 3 c b 4 5 1 c d 1 4 d 1 e b a 4 7 d 
b 2 c 7 5 7 7 5 9 4 9 e 1 6 3 2 e 7 5 b 4 d 5 9 a 8 8 4 9 0 8 a 6 1 e 5 1 c b 6 1 e 9 2 4 3 6 5 5 5 7 1 e d d 3 4 1 c 9 2 4 b 4 5 1 6 7 5 b 2 a 2 c 9 c 3 c d 1 c 7 b 0 c 7 1 6 5 3 6 7 1 4 b a a 4 b 4 
9 8 4 b 4 d b 6 7 7 1 8 2 a e d b 8 6 9 2 0 6 1 c 5 5 1 6 7 5 b a 0 c 7 7 3 8 e 3 e 1 c 3 8 e 1 6 3 e 3 e 1 2 8 6 7 5 7 b 4 d 5 1 2 8 e 5 d b 8 e 1 4 1 e 3 6 5 1 c d 7 7 d 3 e 1 a a c 7 7 9 8 a 2 a 4 
7 7 1 e 1 2 c b c d 5 3 a 8 e 1 c 7 d 7 9 6 b 4 7 7 7 3 8 e 3 a e 7 3 8 e b 0 a 8 e 7 3 e 5 d 3 a c 9 8 e 1 e 7 9 c 3 c b 0 6 5 7 d 3 c 5 1 c 3 c 5 7 1 e 9 a 6 7 7 5 9 8 6 9 8 2 8 e 7 9 a 6 3 e d 9 6 
9 c 7 9 4 d 7 b 4 5 1 e b 6 9 4 7 b 4 b 0 8 e 7 b c b a 2 c b c d d d 3 e 9 0 e 3 8 c b 8 0 4 9 e 3 6 1 e 3 8 c 7 1 a 4 d 7 d 5 d 5 9 4 3 6 3 e 3 6 9 6 9 6 d b 8 8 4 5 1 a 4 7 d 3 e 9 2 8 e d d 1 2 c 
7 1 c 7 5 1 8 e 3 0 4 9 8 a 6 3 8 a 0 c 7 1 c b c 1 e b c 1 8 0 6 5 5 b 8 4 3 8 e 7 1 e 7 7 3 0 8 e d 5 b 8 6 7 9 4 d 5 5 d 3 0 0 4 7 3 c 9 e b 8 8 4 9 6 9 2 e 7 5 3 6 1 c 7 d 1 8 a 0 e 7 9 0 6 5 d 5 
b 4 7 d 1 6 5 b 8 6 1 4 7 d d d 5 9 6 7 9 4 7 d 1 2 a 8 2 4 5 7 9 2 0 a 4 7 b 6 b 8 4 b a 8 e 5 1 e 5 3 e 5 9 e 5 7 1 2 0 6 b 4 5 3 8 c 3 2 a e 7 5 7 1 a 0 a c d 7 d 9 4 5 9 4 7 7 b 2 8 e 7 1 a 6 3 6 
9 2 e 5 7 d 7 b 6 b 4 3 e 1 2 0 6 1 8 c 7 3 e 1 2 8 e 5 9 6 7 b 4 9 6 d 1 a a c d 7 7 b a 0 a 6 3 e 3 a a 0 4 d 7 b 4 9 6 d d 7 5 d 5 3 a e d 9 8 2 e 7 d 7 d 1 6 d 1 4 7 1 4 3 a c b a 6 b 8 0 e 9 c d 
3 c 9 2 8 2 8 a e d 1 e d 7 9 2 c 7 5 1 a c 9 4 9 6 b 4 7 d d d 7 5 9 4 5 9 c 7 1 a a e b 4 9 8 8 8 a e 9 4 5 5 b c 7 3 a 4 1 c 5 5 3 c b 8 0 6 1 8 a c 5 b 2 4 b 4 5 7 9 4 7 b 8 2 c 9 a e 7 1 8 4 1 4 
b 4 3 c 3 c 1 8 e 5 5 b 0 e 3 e 5 d 5 7 b 4 7 7 3 a c 7 b 0 2 2 e 7 7 1 0 6 7 d 1 a 8 e d 3 6 5 5 3 c d 7 5 3 4 b 0 c d d 3 6 5 5 5 b 4 b 6 5 b 4 1 c 5 1 e 9 6 9 2 6 b 4 1 c 9 6 d 3 2 8 e b 6 5 7 7 5 
9 2 a 4 b 6 7 3 a 2 2 a 0 8 e d 5 5 1 c d 1 e d 9 c 1 a 8 2 a c 9 a c 5 1 e d 1 4 b 2 8 6 b c 5 1 c 3 2 e 3 c 3 e 7 3 0 2 8 a 4 5 1 c 3 a c 5 b 4 7 7 5 3 8 6 9 2 e d d 7 5 5 1 c 3 c 9 6 b c b 0 e d 7 
5 b 8 2 a a a a 8 e d d 5 5 d 1 6 3 6 3 6 1 c 1 4 3 6 b 0 c b 0 6 d 5 5 1 a 4 7 1 e 9 6 d d 1 6 7 1 a c b a 0 e 9 a 8 2 e 7 b 6 1 6 3 a e 5 3 c 5 d b 2 c 3 e 3 e b 0 4 b 4 7 7 7 b 0 0 e d 3 8 4 9 2 e 
7 9 2 8 a e b c 5 9 2 0 6 5 1 2 e 9 a c 9 4 7 5 1 8 c 9 4 7 b 4 d 3 6 7 1 c 5 b 4 b 2 e 5 1 6 d 9 2 e 7 9 8 2 c 5 d 3 a a 8 a e 3 e b c 9 4 b 4 1 2 a e 1 a e d b 8 6 3 e 1 a e 9 e 7 5 b 2 a 6 3 2 8 e 
b 4 9 0 a a 8 4 7 1 e 7 b 4 1 e b 0 e 7 5 7 9 6 7 5 5 7 5 b c 1 2 e 9 a 6 5 7 d 3 a a 8 2 0 e 1 2 a a e 5 7 d 7 3 0 a e 9 2 8 a c b c 1 6 7 b 4 3 a e b 2 8 a 4 b 0 c d 9 6 b 8 0 c 9 6 d 9 a a 8 8 6 d 
b 4 5 7 b a 4 5 b 2 a a e 5 3 c d 1 e 9 4 b 0 e b 6 1 e 3 e 3 0 8 e 1 a e 7 b 0 a 8 a 4 b 2 e 3 8 e 9 a 2 a 2 a e 1 e b 4 9 4 d 1 e 3 0 c 9 e 3 a 8 a e b 6 b 0 8 6 7 3 0 a a 6 5 5 3 8 6 5 d 9 4 1 a 6 
9 4 1 a 8 e 5 3 8 e d d b 4 b 0 4 1 c 7 3 c 5 d b a 4 9 c b c 5 7 b 0 a c d 9 2 e 5 b 2 8 a e 9 0 e 1 8 a a 8 e 9 2 8 e 7 7 3 4 1 a c 5 3 2 e 9 c 1 8 8 c d 9 6 1 e 9 a 4 d d 9 4 7 d 5 9 6 3 4 5 3 e d 
7 5 7 b 0 e 1 e 3 a 2 4 d 1 c 7 1 6 1 a e 7 1 0 8 e 3 4 3 8 6 3 e d 5 9 2 4 3 a e 5 b 8 2 c d 7 3 c 5 3 e b 2 e 1 e 1 8 e b a 6 7 d 7 3 e 9 a 4 3 6 7 5 5 1 4 b 2 c 3 c 3 6 5 5 5 d 3 6 7 9 8 6 1 8 e 5 
d 5 b c 3 c 3 c b a a 0 6 5 7 9 6 b 2 8 a e 7 5 5 d b 2 c 3 8 e 9 2 6 1 c 5 b c 9 2 e 5 b 0 2 e b 4 7 d b 8 8 a 6 b 6 1 e b a a c 1 a a e 5 b 4 9 a a 4 7 7 3 e d 7 b 6 b a 4 5 1 2 8 a c 5 7 9 4 3 8 4 
3 6 d 5 9 2 c 3 8 e 9 6 b 6 9 6 d 9 c 1 c 9 c 5 1 4 9 a 6 b 4 9 6 b 8 6 7 1 a 4 5 b a 4 b 4 9 c b 0 e 5 b 4 5 9 a c b 0 e 9 a c 5 3 8 8 8 0 e 7 1 e 9 6 9 a e b 0 a c d 9 a 0 6 3 e 3 e 5 3 e 7 1 e 5 5 
b c 5 1 6 b 0 e 1 c 3 a c d 5 b 2 4 5 5 5 7 1 6 7 7 5 d d b 6 3 a e 1 e b 0 e 7 7 9 c 5 d 1 6 7 b 6 d 1 e 7 1 6 d 5 9 2 8 6 9 2 4 b 6 7 5 1 e b 6 b 2 8 2 8 a a 0 c 5 3 2 c 5 9 e b 8 8 2 e d b 0 c 5 7 
d 5 1 0 e d 5 b 6 3 c d 5 3 6 b 8 6 1 6 1 e 5 9 e b 2 2 4 d d d 9 a 2 e d 7 d d b 6 5 3 4 3 8 e d b 4 1 a a 2 c 5 7 5 d 1 c 3 c 3 8 a c 7 7 d 9 8 8 a 4 b 4 d d 7 7 5 d 9 6 1 0 8 e 7 3 8 a 0 e 7 7 1 e 
1 4 5 7 b 2 6 9 c b 6 3 6 d 9 8 6 b 6 9 2 c 1 6 b c d b 0 4 5 3 0 e b a 0 8 0 0 e b 2 8 2 e 3 e 5 d 1 2 e d b 2 0 e 7 3 6 7 d 7 b 4 d 1 e b 0 6 7 1 e 3 e 1 4 3 8 8 2 6 3 e 7 5 7 b a a 0 e 1 8 c 9 2 c 
7 3 6 d 9 c 9 4 3 e d b 8 2 6 5 9 c b 4 b 6 7 d d 5 1 a 6 5 5 9 2 e b 8 4 5 7 3 8 c 9 2 8 a a a 4 1 2 a 8 4 b c 1 a e b a 8 6 d b 4 3 6 b c 1 c b 4 9 a c 5 1 c 7 3 8 e d b a 2 c d d 9 6 9 4 7 5 7 b 4 
b 8 e 1 4 7 5 3 c 9 2 8 0 c b 2 6 7 b 0 8 a c 1 4 1 4 d b 2 4 3 c b c 7 5 5 d b 4 7 5 b 2 a c d 5 3 a e 5 3 e 3 0 8 e d 9 2 a 0 a 6 b 8 a 0 6 3 e 1 6 9 6 7 7 1 c b 4 b 2 8 a e 3 4 3 2 e 5 7 b 0 e d 7 
d 5 9 6 1 a 6 9 6 3 c 7 7 3 8 8 8 e b 4 5 d 7 7 5 5 7 3 c 9 6 d 1 e 5 d 7 7 5 b 0 a 2 8 e 9 6 3 0 a c d 3 8 a c 5 7 d 3 4 b a 2 8 8 c 7 d 1 e b a 2 e 1 c 9 a 6 5 d 1 8 a 2 a c b 4 b 8 a 0 e 9 2 e 3 c 
3 2 6 d 3 c d 3 c b 0 a c 9 4 7 7 b c 5 3 2 e b 4 1 c b 0 2 8 6 7 d 3 4 b c 3 8 0 e 9 6 b 0 e 9 4 b 2 0 c 3 e 5 5 9 0 c 3 e b 8 6 5 3 e 3 0 8 e 9 a c 5 5 3 c d 3 4 7 3 8 e d 1 e 1 e 7 b 2 e 3 c d b 4 
9 8 a 2 a 2 0 c 7 9 2 e 7 7 7 b a a 4 3 a 8 8 e 1 6 5 9 6 d 7 b 8 4 b 2 8 2 a 4 3 e 7 9 8 4 9 6 5 b a 6 3 a c 7 3 6 7 1 a c d 7 b 4 9 8 e 7 3 e 5 b 6 5 7 b 0 2 c 3 c b 4 b 4 1 e 7 d b 8 8 a e 5 1 8 4 
7 7 d b 8 a 4 1 a 2 8 8 8 a 8 8 a 8 0 e b 4 3 e 7 b 4 3 e 1 8 a 6 1 a e 1 e b 4 b a a 6 5 7 3 e 1 8 8 e b a 4 9 a 8 e 7 9 2 2 c b 2 4 3 c d d b 0 a 8 6 b c 1 c 5 9 6 9 2 e 5 1 a c 1 c 7 1 e 9 0 6 5 7 
b 8 4 d 1 e 5 5 9 8 4 5 5 9 6 1 e 5 7 b c 3 a 8 a c 1 a a 6 7 b a 4 d d 1 e d 5 b 8 e b 4 9 e 9 4 5 5 d b 8 2 0 e 1 c d 5 b a 2 c 9 2 e 3 0 4 b 0 c 1 e 9 6 5 7 7 5 9 4 9 e 1 2 c 1 6 3 e 1 e 5 7 b 4 d 
b 6 3 2 2 e 7 7 7 7 7 7 7 3 e 3 e 3 a a 2 a e 7 b 6 3 a a e b a a 2 2 6 3 e 3 2 a 6 b a 2 6 b 6 7 7 3 2 e 7 b 2 e 7 7 3 2 a a e 7 3 a e b 6 7 b 6 7 3 a 2 e 3 e b 6 7 3 6 b 6 b 6 3 a a e 3 a 6 b a 2 6 
